111111111111131111111111111111111111111111111111111
101000000000000000001000000010000000001000000000001
101111111011111011101011111110111011101011101111101
100000001000101000100010000000100010001010100000101
111111101110101110111010111111101011111010111110101
100000001000000010001010001000101010001010001000101
101111111111111110101011101011101110101010111011111
101000000010000010101010100010001000101010001010001
101011111010111010101010111010111011101011101010101
100010001010101010101000001010001000100000001000101
111110101010101010101111111011101110111111111111101
100000101000100010100000000010100010100010001000101
101111111111101111111110111110101010101010101010101
100000100000100000000010000000101010001010100010101
101110101011111111111011101111101111111010111110101
101010001000000000001000101000100000000010001000101
101011111110111011111110101010111110111111101011101
101000000010100010000010101010000010000000101000001
101010111110111110101010101011111011101111101111111
101010100010000000101010101000001010001000100000001
101010101011111111101010111111101011101010111111101
101010101000000000101010100000001000101010100000101
101011101111101110101110101111111110111010101110101
101000000010001000100010001000000010001010100010001
101011111110111011111011111011101111101010111011101
101000100000101010001010000010001000001010001010001
101111101111101010101010111110101011111011101011111
100000101000100010101000101000101010100000100010001
111110101011101110101111101011111010101110111010101
100010001000100000100000101000001010001000100010101
101111111010111111111110101111101010111011111110101
101000000010100010000000100000101010101000000000101
101011111110101010111111111110101010101111101111101
101000001010001000100000000000101010001000100010001
101111101011111111101011111110101011111010101110101
100010001000000010101000100010101010001010101000102
111010111110111010101110111010101010101010111011101
100010100000100010101010001000100010100010000010001
101010111011101110101011101111111110111111111110111
101010100010100010000010100000001000000000100000101
101010101110111011111010111110101111111110101111101
101010001000001010001000001000100000000000100000101
101111111011111010101110111011111111111111111110101
100000000000001010101000100010000000000000100010101
101111111111101010101110101110111111111110111010101
101000001000101010100010100010001000100000000010101
101111101010101010111011101011101010111111111110101
100000101010001010101000101000100010001000000010001
111110101011111010101110111110101111101011111011101
100000001000000000100000000000100000100000001000001
111111111111111111111111111111111111111111111111111
